SO ./textures/minecraft/diamond.png
NO ./textures/minecraft/grass.png
WE ./textures/minecraft/bale.png
EA ./textures/minecraft/sandstone.png

F 0,102,0
C 0,70,200

11111
110011
 110011
  110011
   110011
    110011
     110011
      110011
       110011
        110011
         110011
          110011
           110011
            110011
              10011
              110011
               110E11
                110011
                 1111