NO ./textures/minecraft/blackstone.png
SO ./textures/minecraft/bale.png
WE ./textures/minecraft/grass.png
EA ./textures/minecraft/sandstone.png

F 0,102,0
C 0,70,200






       111111111111111111111111111111111111111111111111111111111      111111111111111111111111111111111111111111111111111111111
      10000000000000000000000000000000000000000000000000000000N11111111000000000000000000000000000000000000000000000000000000001
      10000000001000000000000000000000001000000000011011100000000000000000000000000000100000000000000000000000000000000000000001
 1111110000000000000000000000000000100000000000000000000001101111111111000000000000000001000000000000000000000000000000000100001
1000000000000000000000000000010000000000000000001000000001  1   100000000000000000010000000000000000000000000000000010000111111
1000000000000000000000000000010000000000000000000000000001      1000000100000000000000000000000000100000000000000000100001
1000000000000000000001000000010000000000000000000000000001      1000000100000000000011000000000000000000000000000000000001
1000000000000000000000000000000000000000000000000000000001      1000000100000000000000000000001000000000000000000000000001
1000000000100110000000000000000000000000001000000000000001      1000000000000000000000000000000000000000001000000100000001
1000000000000101000000000000000000000000000000000000000001      1000000010000000000000000000000000000000000000000000000001
1111111111111111111111000000000000011111111111111111111111      1111111111111111111111000000000000011111111111111111111111
                     100000101000001                                                 100000101000001
                     100010000010001                                                 100010000010001
                     100010000010001  11111111111                                    100010000010001
                     100010000010001  10000000001                                    100010000010001
                     100010000010001  10000000001                                    100010000010001
                     100010000010001  10000000001                                    100010000010001
                     100000111000001  11111011111                                    100000111000001
1111111111111111111111000000000000011111  101  11111111111      1111111111111111111111000000000000011111111111111111111111
1000000000000000000000000000000000000001  101  10000000001      1000000000000000000000000000000000000000000000000000000001
1000000000000000000000000000000000000001  101  10000000001      1000000000000000000000000010000000000000000000000000000001
1000000000000010000000000000011111000001  101  10000000001      1000000000100000000000000000000000000000000000110000000001
1000000010000000000000000000000000000001  101  10000000001      1010000000000000000000000000000000100000000000000000000001
10000000000000000000000000000000000000001110111000000000011111111000000000000000000000000000000000000000000000000000000001
10000000000000000000000000000000000000000000000000100000000000000000000001000000000000010000000000000000000000000000000001
10000001000000000000000111110000000000000100000000000000011111111000000001000000000000000000000000000000000000000000000001
1000000100000000000000000000000000000000010000001000000001      1000000001000000000000000000000000000000000000000010000001
1000000100000000000000000000000000000000000000000000000001      1000000001000000000000000000000000000000000000000000000001
1000000000000000110000000000000000000001000000000000000001      1000000001000000000010000000000000000010000000000000000001
1000000000000000000000000000000000000000000000000000000001      1000000000000000000000000000000000000000000000000000000001
1111111111111111111111111111111111111111111111111111111111      1111111111111111111111111111111111111111111111111111111111
