SO ./textures/minecraft/diamond.png
NO ./textures/minecraft/grass.png
WE ./textures/minecraft/bale.png
EA ./textures/minecraft/sandstone.png

F 0,102,0
C 0,70,200

  111111111111111111111111111111111111111111111
111000000000000000000000000000000000011111
101011111111111111111111111111111111101
101010000000000000000000000000000000101
101010111111111111111111111111111110101
101010100000000000S00000000000000010101
101010101111111111111111111111111010101
101010100000000000000000000000001010101
101010111111111111111111111111111010101
101010000000000000000000000000000010101
101011111111111111111111111111111110101
101000000000000000000000000000000000101
101111111111111111111111111111111111101
100000000000000000000000000000000000001
111111111111111111111111111111111111111