SO ./textures/minecraft/diamond.png
NO ./textures/minecraft/grass.png
WE ./textures/minecraft/bale.png
EA ./textures/minecraft/sandstone.png

F 0,102,0
C 0,70,200







                1111111111111111111 111111111111111111111
          111111111111111111 111111111111111111111
          111111111111111111 111111111111111111111
          1111111111111111111111111111111111111111
         11000000000110000000000011
        11110000011100000000000011
        1001000000000000000000001
111111111011000001110000000000001
100000000011000001110111110111111
11110111111111011100000010001
11110111111111011101010010001
11000000110101011100000010001
10000000000000001100000010001
10000000000000001101010010001
11000001110101011111011110N0111
11110111 1110101 101111010001
11111111 1111111 111111111111