11111111111111111111111111
10000000000000000000C00001
10000010000000000000000001
1111001C000000000011111001
10E10011100000000000001001
11110010000000000010C01001
10000000000C00000011111001
10P00000000000000000000001
1000000000000000C000000001
11111111111111111111111111
